EA                                                              textures/east.png
                                    WE                                                  textures/west.png
C                       204,21,255
F 102,102,153
                                SO                                                  textures/south.png
NO                                                          textures/north.png

111111111111111111111111111111111111
10000000000000000000000000000000000001
10000000000001111011100000000000000001
1000000000000000000000000N000000000001
10000000000000000000000000000000000001
10000000000000000000000000000000000001
10000000000001111011110000000000000001
10000000000000000000000000000000000001
11111111111111111111111111111111111111
