EA                                                              textures/east.png
                                    WE                                                  textures/west.png
        C                                                              204,221,255
F          102,102,153
                                SO                                                  textures/south.png
NO                                                          textures/north.png

 111111111111111111111111111111111111 
100000000000000000000000000000000000E1
10000000000000111111110000000000000001
10000000000001000000000000000000000001
10000000000010000000000000000000000001
10000000000000000000000000000000000001
10000000000000111111110000000000000001
10000000000000000000000000000000000001
 111111111111111111111111111111111111 
