EA textures/east.png
WE textures/west.png
C 225,30,25
F 225,30,240
SO textures/south.png
NO textures/north.png

11111111111111111111111111111111111111
10000000000000000000000000000000000001
10000000000000111111110000000000000001
10000000000000000000000000000000000001
10000000000000000N00000000000000000001
10000000000000000000000000000000000000
10000000000000111111110000000000000001
10000000000000000000000000000000000001
11111111111111111111111111111111111111