EA                                                              textures/east.png
                                    WE                                                  textures/west.png
C 750,30,25
F 200,30,240
                                SO                                                  textures/south.png
NO                                                          textures/north.png

11111111111111111111111111111111111111
10000000000000000000000000000000000001
10000000000001111D11110000000000000001
1000000000000D000000000000000000000001
1000000000000D000N00000000000000000001
1000000000000D000000000000000000000001
10000000000001111D11110000000000000001
10000000000000000000000000000000000001
11111111111111111111111111111111111111