                    EA                      textures/east.png      
            WE                      textures/west.png                   
            F                           255      ,0      ,0                                                    
                    C 255    ,5             ,5                    

 NO                                 textures/north.png
                        SO                         textures/south.png                        

1111111111111111111111111
1000000000110S00000000000111111
1000000000000000001111111000011
10110000011100000001    1000001                                                     
1111111111111111111111111111111
10010000000000000000000011111111   
111111111011000001110000000000001
100000000011000001110111111111111
11110111111 11011100000010001
1111011111111101110101010001
11000000110101011100000010001
1000000001000001100000010001
10000000000000001101010010001
1100000111010101111101111000111
11110111 1110101 101111010001
11111111 1111111 111111111111
111111