1111111111111
10C1CCCCCC011
1000011111011
1P0C11E0CC0C1
1111111111111
